888888888888888888888888
820000001000000400000008
801111101011111401111108
800000001000000400000008
801111101011111101111108
800000004000000100000008
844411101011111101111108
800000001000000444444448
801111101011111101111108
800004001000000100000008
801114101011111101111108
800000001000000100000018
800000001000000130000008
888888888888888888888888
