88888888888888888888
80000000010000044038
80011110010111114008
80000000010000010008
80111110041111010008
80000000040000010008
80011110010111010008
80044000014001010008
80010111114101040008
80010000410001014008
82011111010141011008
88888888888888888888