1111111111111111
1000000100000301
1044400100444011
1000400100004011
1000400111000111
1000400001000111
1000444401000111
1000000401000011
1200000400000011
1111111111111111