8888888888888888
8200000100004108
8011100101114108
8000100100000008
8010100441111108
8010100101000008
8000100101011108
8011100101000008
8000040100000038
8888888888888888