2222222222222222222222222222222222222222222222222222
2                                                  2
2                                                  2
2                                                  2
2             1                                    2
2                                                  2
2                                                  2
2                                                  2
2                                                  2
2                                                  2
2                                                  2
2                                      1           2
2                                                  2
2                                                  2
2                                                  2
2          1                                       2
2                                                  2
2                                                  2
2                                                  2
2                                                  2
2                                                  2
2                                                  2
2                                                  2
2                                                  2
2                                                  2
2222222222222222222222222222222222222222222222222222